111111111111111111111111111111111111111111111
1000000C111111C000C111111111110C001N001101N11
1P00000000C111110111111C00000000CC000N0000C11
1111111100000N0000000000111111111111111111111
1000N0000001111101111110000000000000000C00011
111111110000000000000000111111111111111111111
10N000N0000111110000000000000N000000000000C11
11111111000N000000000000111111111111111111111
1000CN00C001111101111110000000000000000000C11
111111110000C000C000C000111111111111111111111
100C00N0C0011111011111100C000C000C0000C000CE1
111111111111111111111111111111111111111111111