111111111111111111111111111111111
1P000000000000001CE00100000010101
1111111111000C0000010000001111111
111111111111111111111111111111111