111111111111111111111111111111
110111111000P000000000000000E1
111111C000N1111111111111111111
111111111111111111111111111111