1111111111111111111111
1000P00000110000000011
1000000000000000000001
1000000000000N000000E1
1111111111111111111111
