1111111111111111111111111111111111111111111111111111111111111
1000000000000000000000000000000000000000000000000000000000111
1000001000011110000000000000000000000000000000000000000000111
1P000000000000N0000000001111110000N0000N00000000000000000E111
1111111111111111111111111111111111111111111111111111111111111
