111111111111111111111111111111111111111111111111
111C000010C1110C00000000001111111111111111111111
11111P000011111111111111101111111111111111111111
11111N000001111111111111101111111111111111111111
111110000000000000000000000E11111111111111111111
111111111111111111111111111111111111111111111111