111111111111111111111111111111111111111111111
1000000C111111C000C111111111110C0010001101011
1P00000000C111110111111C00000000CC00000000C11
111111110000000000000000111111111111111111111
100000000001111101111110000000000000000C00011
111111110000000000000000111111111111111111111
100000000001111100000000000000000000000000C11
111111110000000000000000111111111111111111111
1000C000C001111101111110000000000000000000C11
111111110000C000C000C000111111111111111111111
100C0000C0011111011111100C000C000C0000C000CE1
111111111111111111111111111111111111111111111