1111111111111111111111
1CCP000000000000100011
1CC11111C10000000000E1
1111111111111111111111